{
    "layouts": [
        {
            "nightly_layout": {
                "q": 16,
                "w": 17,
                "e": 18,
                "r": 19,
                "t": 20,
                "a": 30,
                "s": 31,
                "d": 32,
                "f": 33,
                "g": 34,
                "z": 44,
                "x": 45,
                "c": 46,
                "v": 47,
                "b": 48
            },
            "sky_layout": {
                "y": 21,
                "u": 22,
                "ı": 23,
                "o": 24,
                "p": 25,
                "h": 35,
                "j": 36,
                "k": 37,
                "l": 38,
                "ş": 39,
                "n": 49,
                "m": 50,
                "ö": 51,
                "ç": 52,
                ".": 53
            }
        }
    ]
}